3 3 4 2 6 2 3 4 5
3 3 2 4 6 2 3 4 5
3 3 4 6 6 6 3 4 5
3 3 2 4 6 2 3 4 5
3 3 4 2 6 2 3 4 5